[tiles]
1,1,1,1,1,1,1,1,1,1,1,1,1,1,1,1,1,1,1,1,1,1,1,1,1,1,1,1,1,1,1,1
1,1,1,1,1,1,1,1,1,1,1,1,1,1,1,1,1,1,1,1,1,1,1,1,1,1,1,1,1,1,1,1
1,1,1,1,1,1,1,1,1,1,1,1,1,1,1,1,1,1,1,1,1,1,1,1,1,1,1,1,1,1,1,1
1,0,0,0,0,0,0,0,0,0,0,0,0,0,0,0,0,0,0,0,0,0,0,0,0,0,0,0,0,0,0,1
1,0,0,0,0,0,0,0,0,0,0,0,0,0,0,0,0,0,0,0,0,0,0,0,0,0,0,0,0,0,0,1
1,0,0,0,0,0,0,12,9,9,9,9,9,9,9,9,9,9,9,9,9,9,9,9,9,9,9,9,9,9,13,1
1,0,0,0,0,0,0,10,1,1,1,1,1,1,1,1,1,1,1,1,1,1,1,1,0,0,0,0,0,0,10,1
1,0,0,0,0,0,0,10,1,1,1,1,1,1,1,1,1,1,1,1,1,1,1,1,0,0,0,0,0,0,10,1
1,12,9,13,0,0,0,10,1,1,1,1,1,1,1,1,1,1,1,1,1,1,1,1,0,0,0,0,0,0,10,1
1,10,0,10,0,0,0,10,1,1,1,1,1,1,1,1,1,1,1,1,1,1,1,1,0,1,1,1,1,1,10,1
1,11,9,14,0,0,0,11,9,9,9,9,9,9,9,9,9,9,9,9,9,9,9,9,9,9,9,9,9,9,14,1
1,0,0,1,1,1,1,1,1,1,1,1,1,1,1,1,1,1,1,1,1,1,1,1,1,1,1,1,1,1,1,1
1,0,0,0,0,0,1,12,9,9,9,9,9,9,9,9,9,9,9,9,9,13,1,1,1,1,7,1,1,1,1,1
1,0,0,0,0,0,1,10,1,1,1,1,1,1,1,1,1,1,1,1,1,10,0,1,1,1,0,0,0,0,0,1
1,0,0,0,0,0,1,10,1,1,1,1,1,1,1,1,1,1,1,1,1,10,0,1,1,1,0,0,0,0,0,1
1,0,0,0,0,0,0,11,9,9,9,9,9,9,9,9,9,9,9,9,9,14,0,0,0,0,0,0,0,0,0,1
1,1,3,1,1,1,1,1,1,1,1,1,1,1,1,1,1,1,1,1,1,1,1,1,1,1,1,1,1,1,0,1
1,0,0,0,0,1,12,9,9,9,9,9,9,9,9,9,9,9,13,1,12,9,9,9,9,9,9,9,9,13,0,1
1,0,0,0,0,1,10,1,1,1,1,1,1,1,1,1,1,1,10,1,10,1,1,1,1,1,1,1,1,10,0,1
1,0,0,0,0,1,10,1,1,1,1,1,1,1,1,1,1,1,10,1,10,1,12,9,9,9,9,13,1,10,0,1
1,0,0,0,0,1,10,1,1,1,1,1,1,1,1,1,1,1,10,1,10,1,10,0,0,0,0,10,1,10,0,1
1,0,0,0,0,0,11,9,9,9,9,9,9,9,9,9,9,9,14,0,11,9,14,0,0,0,0,11,9,14,0,1
1,1,1,1,1,1,1,1,1,1,1,1,1,1,1,1,1,1,1,1,1,1,1,1,1,1,1,1,1,1,7,1
1,1,1,1,1,1,1,1,1,1,1,1,1,1,1,1,1,1,1,1,1,1,1,1,1,1,1,1,1,1,1,1
[bouncer_position]
75,500
[exitdoor_position]
700,175
[next_map]
level25.txt
[rail_saws]
400,538,left
675,538,right
550,538,left
550,313,left
350,137,right
350,137,left
175,263,right
75,263,right
[main_music]
2