[tiles]
1,1,1,1,1,1,1,1,1,1,1,1,1,1,1,1,1,1,1,1,1,1,1,1,1,1,1,1,1,1,1,1
1,1,1,1,1,1,1,1,1,1,1,1,7,1,1,1,1,1,1,1,1,1,1,1,8,8,8,8,1,7,1,1
1,0,0,0,0,0,0,0,0,0,0,1,12,9,9,9,9,9,9,13,0,0,0,0,0,0,0,0,0,0,0,1
1,0,0,0,0,0,0,0,0,0,0,1,10,0,0,0,0,0,0,10,0,0,0,0,0,0,0,0,0,0,0,1
1,0,0,0,12,9,9,9,9,9,13,1,11,9,9,9,9,9,9,14,1,12,9,9,9,9,9,9,13,0,0,1
1,0,0,0,10,0,0,0,0,0,10,0,0,0,0,0,0,0,0,0,1,10,0,0,0,0,0,0,10,0,0,1
1,0,0,0,11,9,9,9,9,9,14,0,0,0,0,0,0,0,0,0,1,11,9,9,9,9,9,9,14,0,0,1
1,1,1,1,1,1,1,1,1,1,1,1,1,1,1,1,1,1,1,1,1,7,1,1,1,1,1,1,1,1,0,1
1,1,1,1,3,3,3,3,3,3,1,1,1,1,1,1,3,3,3,3,3,3,1,1,1,1,8,8,8,1,0,1
1,8,1,12,9,9,9,9,9,9,13,0,0,0,0,12,9,9,9,9,9,9,13,0,0,0,0,0,0,0,0,1
1,0,0,10,0,0,0,0,0,0,10,0,0,0,0,10,0,0,0,0,0,0,10,0,0,0,0,0,0,0,0,1
1,0,0,10,0,0,0,0,0,0,10,0,0,0,0,10,0,0,0,0,0,0,10,0,0,0,0,0,0,0,0,1
1,0,0,10,0,0,0,0,0,0,10,0,0,0,0,10,0,0,0,0,0,0,10,0,0,0,0,0,0,0,0,1
1,0,0,10,0,0,0,0,0,0,10,0,0,0,0,10,0,0,0,0,0,0,10,0,0,0,0,0,0,0,0,1
1,0,0,11,9,9,9,9,9,9,14,0,0,0,0,11,9,9,9,9,9,9,14,0,0,0,0,0,0,0,0,1
1,0,1,1,1,1,1,1,1,1,1,1,1,1,1,1,1,1,1,1,1,1,1,1,1,1,1,1,1,1,1,1
1,0,8,8,8,8,8,8,0,0,0,8,8,8,8,8,8,0,0,0,0,8,8,8,8,8,8,0,0,0,0,1
1,0,0,0,0,0,0,0,0,0,0,0,0,0,0,0,0,0,0,0,0,0,0,0,0,0,0,0,0,0,0,1
1,0,0,0,0,0,0,0,0,0,0,0,0,0,0,0,0,0,0,0,0,0,0,0,0,0,0,0,0,0,0,1
1,0,0,0,0,0,0,0,0,0,0,0,0,0,0,0,0,0,0,0,0,0,0,0,0,0,0,0,0,0,0,1
1,0,0,0,0,0,0,0,0,0,0,0,0,0,0,0,0,0,0,0,0,0,0,0,0,0,0,0,0,0,0,1
1,0,0,0,0,0,0,0,0,0,0,0,0,0,0,0,0,0,0,0,0,0,0,0,0,0,0,0,0,0,0,1
1,7,3,4,3,4,3,4,1,1,1,3,4,3,4,3,4,1,1,1,1,3,4,3,4,3,4,1,1,1,1,1
1,1,1,1,1,1,1,1,1,1,1,1,1,1,1,1,1,1,1,1,1,1,1,1,1,1,1,1,1,1,1,1
[bouncer_position]
750,475
[exitdoor_position]
50,125
[moving_platforms]
[rail_saws]
87,300,down
87,300,up
263,300,down
263,300,up
387,300,down
387,300,up
563,300,down
563,300,up
145,162,right
145,112,left
450,112,right
550,162,right
625,112,left
[laser_guns]
667,350,1000,3000,up
[next_map]
level44.txt
[main_music]
3
