[tiles]
1,1,1,1,1,1,7,1,1,1,1,1,1,1,1,1,1,1,1,1,1,1,1,1,1,1,1,1,1,1,1,1
1,0,0,0,0,0,0,1,1,0,0,0,0,0,0,0,0,0,0,0,0,0,0,0,0,0,0,0,0,0,0,1
1,0,0,0,0,0,0,0,0,12,9,9,9,13,0,0,0,0,0,0,0,0,0,0,0,0,0,0,0,0,0,1
1,0,0,0,0,0,0,0,0,10,0,0,0,10,0,0,0,0,0,0,0,0,0,0,0,0,0,0,0,0,0,1
1,0,0,0,0,0,0,0,0,10,0,0,0,10,0,0,0,0,0,0,0,0,0,0,0,0,0,0,0,0,0,1
1,0,1,1,1,1,1,1,0,10,0,0,0,11,9,9,9,9,9,9,9,9,9,9,9,9,9,13,0,0,0,1
1,0,1,7,4,4,4,1,1,11,13,0,0,0,0,0,0,0,0,0,0,0,0,0,0,0,0,10,0,0,0,1
1,0,0,0,0,0,0,4,1,1,11,9,9,9,9,9,9,9,9,9,9,9,9,9,9,9,9,14,0,0,0,1
1,0,18,9,9,9,9,16,4,1,1,1,1,1,1,1,1,1,1,1,1,1,1,1,1,1,1,1,1,1,1,1
1,0,18,9,9,9,9,9,16,4,4,4,4,4,4,4,4,1,4,4,4,4,4,4,4,4,1,1,1,1,1,1
1,0,0,0,0,0,0,0,0,0,18,9,9,9,9,9,9,9,9,9,9,9,9,9,9,16,0,0,0,0,0,1
1,0,0,0,0,0,0,0,0,0,0,0,0,0,0,0,0,0,0,0,0,0,0,0,0,0,0,0,0,0,0,1
1,0,0,0,0,0,0,0,0,0,0,0,0,0,0,0,0,0,0,0,0,0,0,0,0,0,0,0,0,0,0,1
1,0,0,0,0,0,0,0,0,0,0,0,0,0,0,0,0,0,0,0,0,0,0,0,0,0,0,0,0,0,0,1
1,7,1,1,1,1,1,0,0,0,0,0,0,0,0,0,0,0,0,0,0,0,0,0,0,0,0,0,0,0,0,1
1,1,1,1,1,1,1,0,0,0,0,0,0,0,0,0,0,0,0,0,0,0,0,0,0,18,9,9,9,9,16,1
1,0,0,0,0,0,0,0,0,0,0,0,0,0,0,0,0,0,0,0,0,0,0,0,0,0,0,0,0,0,0,1
1,0,0,0,0,0,0,0,0,0,0,0,0,0,0,0,0,0,0,0,0,0,0,0,0,0,0,0,0,0,0,1
1,0,0,0,0,0,0,0,0,0,0,0,0,0,0,0,0,0,0,0,0,0,0,0,0,0,0,0,0,0,0,1
1,0,0,0,0,0,0,0,0,0,12,9,13,0,0,12,9,13,0,0,12,9,13,0,0,0,0,0,0,0,0,1
1,1,1,1,1,1,1,0,0,0,10,1,10,0,0,10,1,10,0,0,10,1,10,0,0,1,1,1,7,1,1,1
1,1,1,1,1,1,1,0,0,0,11,9,14,0,0,11,9,14,0,0,11,9,14,0,0,1,1,1,1,1,1,1
1,1,1,1,1,1,1,1,0,0,0,0,0,0,0,0,0,0,0,0,0,0,0,0,0,1,1,1,1,1,1,1,1
1,1,1,1,1,1,1,1,1,1,1,1,1,1,1,1,1,1,1,1,1,1,1,1,1,1,1,1,1,1,1,1
[bouncer_position]
50,450
[exitdoor_position]
725,150
[next_map]
level27.txt
[main_music]
2
[rail_saws]
300,487,right
450,487,left
550,487,right
550,262,right
724,387,left
75,212,right
100,238,right
403,138,right
603,138,right
400,187,left
600,187,left
250,63,right
237,197,up
[laser_guns]
175,355,1200,3000,right
