[tiles]
1,7,1,1,1,1,1,1,1,1,1,1,1,1,1,1,1,1,1,1,1,1,1,1,1,1,1,1,1,1,1,1
1,0,0,0,0,1,18,9,9,9,9,9,9,9,9,9,9,9,9,9,9,9,9,9,16,1,0,0,0,0,0,1
1,0,1,0,0,1,1,1,1,1,0,1,1,1,1,1,1,1,1,1,1,0,1,1,1,1,0,0,0,0,0,1
1,0,1,0,0,18,9,9,9,9,9,9,9,9,9,9,9,9,9,9,9,9,9,9,9,16,0,0,0,0,0,1
1,0,1,0,0,1,1,1,1,1,1,1,1,1,1,1,1,1,1,1,1,1,1,1,1,1,1,1,1,1,1,1
1,0,1,0,0,0,0,0,0,0,15,0,0,0,15,0,0,0,15,0,0,0,15,0,0,0,0,0,0,0,0,1
1,0,1,0,0,0,0,0,0,0,10,0,0,0,10,0,0,0,10,0,0,0,10,0,0,0,0,0,0,0,0,1
1,0,1,0,0,0,0,0,0,0,10,0,0,0,10,0,0,0,10,0,0,0,10,0,0,0,0,0,0,0,0,1
1,0,1,0,0,0,0,0,0,0,10,0,0,0,10,0,0,0,10,0,0,0,10,0,0,0,0,0,0,0,0,1
1,0,1,1,1,1,0,0,0,0,10,0,0,0,10,0,1,0,10,0,0,0,10,0,0,0,0,1,1,1,7,1
1,0,1,1,1,1,0,0,0,0,17,0,0,0,17,0,0,0,17,0,0,0,17,0,0,0,0,1,1,1,1,1
1,0,1,1,1,1,2,2,2,2,2,2,2,2,2,2,2,2,2,2,2,2,2,2,2,2,2,1,1,1,1,1,1,1
1,0,1,1,1,1,1,1,1,1,1,1,1,1,1,1,1,1,1,1,1,1,1,1,1,1,1,1,1,1,1,1,1
1,0,1,0,0,0,0,0,0,0,0,0,0,0,0,0,0,0,0,0,0,0,0,0,0,0,0,0,0,0,0,1
1,0,1,0,0,0,18,9,9,9,9,9,9,9,9,9,9,9,9,9,9,9,9,9,9,9,16,0,0,0,0,1
1,0,1,0,0,0,0,0,0,0,0,0,0,0,0,0,15,0,0,0,0,0,0,0,0,0,0,0,0,0,0,1
1,0,1,1,1,1,0,0,0,0,0,0,0,0,0,0,10,0,0,0,0,0,0,0,0,0,0,0,0,0,0,1
1,0,0,0,0,0,0,0,0,0,0,0,0,0,0,0,10,0,0,0,0,0,0,0,0,0,0,0,0,0,0,1
1,0,0,0,0,0,0,0,0,0,0,0,0,0,0,0,10,0,0,0,0,0,0,0,0,0,0,0,0,0,0,1
1,0,0,0,0,0,0,0,0,0,0,0,0,0,0,0,17,0,0,0,0,0,0,0,0,0,0,0,0,0,0,1
1,1,1,1,1,1,0,0,0,0,0,0,0,0,0,0,0,0,0,0,0,0,0,0,0,0,0,1,1,7,1,1
1,1,1,1,1,1,2,2,2,2,2,2,2,2,2,2,2,2,2,2,2,2,2,2,2,2,2,1,1,1,1,1
1,1,1,1,1,1,1,1,1,1,1,1,1,1,1,1,1,1,1,1,1,1,1,1,1,1,1,1,1,1,1,1
1,1,1,1,1,1,1,1,1,1,1,1,1,1,1,1,1,1,1,1,1,1,1,1,1,1,1,1,1,1,1,1
[bouncer_position]
750,75
[exitdoor_position]
100,350
[next_map]
level28.txt
[rail_saws]
400,88,right
400,38,left
262,200,down
362,200,up
462,200,down
562,200,up
412,400,down
400,363,right
[moving_platforms]
362,225,left
562,225,right
262,500,left
[main_music]
2
