[tiles]
1,1,1,1,1,1,1,1,1,1,1,1,1,1,1,1,1,1,1,1,1,1,1,1,1,1,1,1,1,1,1,1
1,0,0,0,0,0,0,0,0,0,1,0,0,0,0,0,0,0,0,0,0,0,0,0,0,0,0,0,0,0,0,1
1,0,0,0,0,0,0,0,0,0,1,0,0,0,0,0,0,0,0,0,0,0,0,0,0,0,0,0,0,0,0,1
1,0,0,0,0,0,0,0,0,0,1,0,0,0,0,0,0,0,0,0,0,0,0,0,0,0,0,0,0,0,0,1
1,1,1,1,1,0,0,0,0,0,1,0,0,0,1,1,1,1,1,1,1,1,1,1,0,0,0,0,0,0,0,1
1,0,0,0,1,6,0,0,0,5,1,0,0,0,1,1,1,1,1,1,1,8,1,1,0,0,0,0,0,0,0,1
1,0,0,0,1,6,0,0,0,5,1,0,0,0,0,0,0,0,0,0,0,0,0,1,0,0,0,0,0,0,0,1
1,0,1,0,1,6,0,0,0,5,1,0,0,0,0,0,0,0,0,0,0,0,0,1,0,0,0,0,0,0,0,1
1,0,1,0,1,6,0,0,0,5,1,3,0,0,0,0,0,0,0,1,6,0,5,1,0,0,0,0,0,0,0,1
1,0,1,0,1,6,0,0,0,5,1,0,0,0,0,0,0,0,0,1,6,0,5,1,0,0,0,0,0,0,0,1
1,0,1,0,1,6,0,0,0,5,1,0,0,0,0,0,0,0,0,1,6,0,5,1,0,0,0,0,0,0,0,1
1,0,1,0,1,0,0,0,0,0,1,0,0,0,0,0,0,0,0,1,6,0,5,1,0,0,0,0,2,2,2,1
1,0,1,0,0,0,0,0,0,0,1,0,0,0,0,0,0,0,0,1,6,0,5,1,0,0,0,0,1,1,1,1
1,0,1,0,0,0,0,0,0,0,1,1,3,1,1,1,1,1,1,1,6,0,5,1,0,0,0,0,0,0,0,1
1,0,1,1,1,2,2,2,2,2,1,1,1,1,1,1,1,1,1,1,6,0,5,1,2,2,0,0,0,0,0,1
1,0,1,1,1,1,1,1,1,1,1,1,1,1,1,1,1,1,1,1,6,0,5,1,1,1,0,0,0,0,0,1
1,0,1,0,0,0,0,0,0,0,0,0,0,0,0,0,0,0,0,0,0,0,0,0,0,1,0,0,0,1,1,1
1,0,1,0,0,0,0,0,0,0,0,0,0,0,0,0,0,0,0,0,0,0,0,0,0,1,0,0,0,0,0,1
1,0,1,0,0,0,0,0,0,0,0,0,0,0,0,0,0,0,0,0,0,0,0,0,0,1,0,0,0,0,0,1
1,0,1,0,0,0,0,0,0,0,0,0,0,0,0,0,0,0,0,0,0,0,0,0,0,1,2,2,2,2,2,1
1,0,0,0,0,0,0,0,0,0,0,0,0,0,0,0,0,0,0,0,0,0,0,0,0,1,1,1,1,1,1,1
1,0,0,0,0,0,0,0,0,0,0,0,0,0,0,0,0,0,0,0,0,0,0,0,0,1,1,1,1,1,1,1
1,2,1,1,1,1,3,2,2,2,2,2,2,2,2,2,2,2,2,2,2,2,2,2,2,1,1,1,1,1,1,1
1,1,1,1,1,1,1,1,1,1,1,1,1,1,1,1,1,1,1,1,1,1,1,1,1,1,1,1,1,1,1,1
[bouncer_position]
50,50
[exitdoor_position]
740,350
[next_map]
level10.txt
[moving_platforms]
200,200,left
75,200,down
200,345,right
450,475,right
525,450,up
675,450,left
675,250,right
675,150,left